

closedDoorTex ./assets/textures/doors/porte 512x512.xpm

animSprite MONSTER_1, 4, XPM, ./assets/sprites/monster_mummie_

NO ./assets/textures/creepy/brown_old_wall_2.xpm
SO ./assets/textures/creepy/brown_old_wall_3.xpm
WE ./assets/textures/creepy/cement_old_wall_1.xpm
EA ./assets/textures/creepy/blood_old_wall.xpm

FloorTex ./assets/textures/floor-ceil/cracked-creme-granite_tiled_512x512.xpm
CeilTex  ./assets/textures/floor-ceil/white-cubes-3d_tiled_512.xpm

C 70,70,70
F 150,150,150


11111111111111111111111111111111111111111111111111
1110000111100001110000A000111110010000111111100011
11100001111000011100000000111110010000111011100011
1000000C000000000C000000000000C000000000C000C00001
1110000110000000110A00000011111001000A011011100011
11100001100000001100000000111110010000011011100011
1000000C00000000C0000000000000000C0000000000000001
11110111111000001101001C10111110010000011011100011
1111011111100000110100000011111001A000011011100011
1111C111111000A11101000000111110010000011C11100011
100000000C000000C000000000C000C00000000C000C000001
1111C100111A00011101000000111110A1000001111110A011
111101001110000111C1000000111110010000111111100011
1111C10A111000011101000000111110010000111111000001
10C000000000000000000000000C00C0000A00C00C00000001
111101001110000101A1001010111110010000111111100011
1111C100111000010101A0101011111001000A111111100011
10000000C000000C000000C000000C00000000000000000001
1111011111100001C1000010000111000000A0111111100011
1111C111111000010100001000011100000000111111100011
10000000110A00A11100001000011100000000111111100011
100000000C000000C000000000000000000000000C00000001
1000000011100A0111A1001000011100000000111111100011
10000000111A00011101001C10111100000A00111111100011
1111C111111000000101A0101011110000A000111111100011
111101111110000001C1001C1C111110010000111111100011
10000000000000000000000000000000000000000000000001
10000A0000A0000A0000000000000000000000000000000001
100000A0000000000000000000000000000000000000000001
1110A011111000000100000010111110010000111111100011
11110111111000000100000010111110010000111000100011
11110111111000000100000010000000010000111000100001
10000A00000000000000000000000000000000000000000001
10000000000000000000000000000000000000000000000001
1000000000000000000000AA0000000000000000000000A001
1111C111111A00000000001C100000000A0000111000100001
1111011111100001110100101000000A0000A0111000100001
11110111111000011101000A1000000001A000111111100001
1000000C0000000000000000C00000000000000000C0000001
111101111110000111C100001011111001A000111111100011
11110111111000011101000010111110000000000A00000011
11110111111000000101A00010111110000000000000000011
1111C11111100000W10100001C111110000000000000000011
100000000000A0000000A000000000000000000A00000000A1
100000000000000A0000000000000000000000000000000001
10000000A00000000000000A00000000000000000000000001
1111C11111100000010100101C11111000A000111111100011
11110111111000000101001010111110000000111111100011
11110111111A00011101001010111110010000111111100A11
11111111111111111111111111111111111111111111111111