

closedDoorTex ./assets/textures/porte 512x512.xpm

animSprite MONSTER_1, 4, XPM, ./assets/textures/monster_mummie_

NO ./assets/textures/brown_old_wall_2.xpm
SO ./assets/textures/brown_old_wall_3.xpm
WE ./assets/textures/cement_old_wall_1.xpm
EA ./assets/textures/blood_old_wall.xpm

C 70,70,70
F 150,150,150


11111111111111111111111111111111111111111111111111
11111111111011111100111101111110100111111110111111
11111111111011111100111101111110100111111110111111
1111111111101111110011110111111A100111111110111111
11111111111011111100111100111110100111111110111111
11111100000000001100111100111110100111111110111111
111111000000000A1100111100111110100111111110111111
111111000A0000A011A0111100111110100111111110111111
1000000000000000A0000000000000000A0000000000000C01
11111100000000001100111100111110100111111110111111
1111110A000000001100111100111110100111111110111111
11111100000000001100111100111110100111111110111111
1111110000A00000110011110011111A100111111110111111
11111100000000001100111101111110100111111110111111
1111110000000000110011110111110000A000011110111111
111111000000000011001111011111000NA000011110111111
1111111111101111110011100011110000000001111C111111
11111111111011111100111A00111100000A00011110111111
11111111111011111100111000111100000000011110111111
11111111111011111100111000111100A0A000011110111111
11111111111011100000A11000111100A00000011110111111
11111111111011100A00011101111100000000011110111111
111111111110111000000111011111A0A00000011110111111
11111111111011100000011101111100000000011110111111
1111111111101110A000011101111110100111111110111111
11111111111011100000011101111110100111110000001111
10000000000000000000A00A00000000A00000000000000001
111111111110111000000111011111101001111100A0001111
11111111111A111000000111000A0000000001110000001111
10011111111011100A000111A0000000000001110000001111
100111111110111000000111000000A0000001110000001111
100C0000000000000000000000000000A0000000A000000001
100110000000001111A0111100000000000001110000001111
1111100000000011110011110A000A00000001110A00001111
11111000000000111100111100000000000001111110111111
1111100000000011110A1111000000000A0001111110111111
1000A000000000000C00000000000000000000000000000001
11111000A000001111A0111101111110100111111110111111
111110000000001111001111A1111110100111111110111111
1111100000000A111100111101111110100111111110111111
11111000000000111100111101111110100111111110111111
11111111111011111100111101111110100111111110111111
11111111111011111100111101111110100111111110111111
11111111111011A0000000000111111A100111111110111111
1111111111101100000000A00111111010A111111110111111
11111111111011000000A00001111110100111111110111111
11111111111011000A00000001111110100111111110111111
1111111111101100000000000111111010011111111C111111
11111111111011000000000001111110100111111110111111
11111111111111111111111111111111111111111111111111