

closedDoorTex ./assets/textures/doors/porte 512x512.xpm

NO ./assets/textures/creepy/brown_old_wall_2.xpm
SO ./assets/textures/floor-ceil/wall-grey-blocks-photos2-512.xpm
WE ./assets/textures/creepy/cement_old_wall_1.xpm
EA ./assets/textures/creepy/blood_old_wall.xpm

FloorTex ./assets/textures/floor-ceil/black-marbled-surface-tiled512.xpm
CeilTex  ./assets/textures/floor-ceil/cracked-creme-granite_tiled_512x512.xpm

C 70,70,70
F 150,150,150

1111111111111111111111111111111111111111111111111111111111111111111111111111111111111111111111111111
1010000001010000001000000110111100000000100010100000000001100000000011000000100011110001000010100001
1000001100001101100101100000001100010000001001101000111010001000010100000110001000000100101000110101
111000100010101010010000010100110110101000100000011010001010010100110100000100C011010100101011000101
1100100100101000100101000001001000001011101110100000101010100C01011000001101111000011000000100000101
1101001001011110000100101010100010001010001000100000000000110101111000000110000011000010010010110101
1010101A10011100110101010010C01A11101011011101110001111010101000001010110011011000101000101000000101
1010101001100000100100001000101001001000000010001010000000100101101010000010000000001010010010010101
100011000001111001010110100100001000001101110111101010111101001000001010110010110110A001101000111001
1111011110100010110001010011110110111110000010C000001010100000100001000010011010010001A0000010000011
100000A000101010100100000100100010010001001000100010000101010111000111101000000000100001101000000011
1010100000110000101000000110110010111110000001010000111010001001010100001000001010101110101101101011
10000110100001100010100000010101100000010101010101A0101010100100011101010101000000010000000000001C11
1011010010110001001000101100000001101010100100010100101000100100101000000010100010001011000110101001
11000000100011C1101000010000100100000010010010010100100100100100101001101000C011111100C0010000101001
111111101100010000111C101101101111110000110001000000101100110001000011001011100010000011001000100001
100000010100010010000001000000000000001C100100000101000010100110101101101000010110111010100001110101
1000010000001001101010010010001010101000111010000100101000100000101001010111100000000010000000000011
1011001110100110100000000001110100000000100101010100101010101000100100010A01001101011001000111000111
1010100000000001001111010100000010101010010000010100001000100110100011000101000101000010010000010001
1000101010100100000001000100010101001001010101001101101010001000111000001011010100011000101010101101
10101000000000010110100010100101000010A1000101100100100101000001001000110011110101100010100010100001
1010000111100110100010100000100001010101010000010010000C010011101101010010101101110110110010101A1111
10101110001010C0010110111100000001010010A10011110011010100000000000000000011000001000000001011000101
101000001110111101000000011101011001000100010001000100000111A010101001101100100100001111101000001101
10C000101001000001010110001001000010010101011111000101C100000110111001000000100010101111000100001001
1011011010001101011100001111101110100100111000001110110001010110000000001110001000010110110110000111
100000001A0000010100010110001000C0000000001101110000000110010000011101101111111011010C00001001010011
101010110001010001110110101110101000001000000C001101000000111011100001000110000000000110000111110001
1010100000010001000101010100101000001010000001010101100010001100100110000001111011010000000000000011
101100010100100C0101100101000010101010100010010101011110A0101010000100000100001010010010111101001011
110000100010100110100010100010100000000010101000000100010010000001001101001A100001101110101001000001
101000111001100000111C10001001101100101010100A101100110000000110110000010010100101010001010100011011
101110001000110101001000000110000110000A000101000101000001000000010001001000000101010010000011001111
1000001010000111000001011100010110001001000000010001010101001011110010000010101001000001001000101001
111001101100010101000100000001001010010000001000010100010011000001001111010001010001010100001C100011
1101110010101000011000101110100101100111101010111001011101010011001110000000000000101001001000101001
10100010001000101000000000001001100100000000100010001100000100111000A0001110110100001100000010101011
1001100010110010100101011110000000101100101010100000101100010000001100100000100C01010010011101000001
1000101010000010101101000000101000011001001000101011100000100010100101000011110110011100000001000111
1011010101111110010C000001101011010A11010010101010001010000000100000001010101000000111011010000A1101
110001010000000101010111000100000000101001111C1C1010000111000000001010001000101111000001011011011001
100101A1010101101010100101101010111000110010100000110101011A1010100000001010101000101110101110010101
11100A00010100010110100C00010010011111001010001101000001C1010110110101010101000001000110001110100001
10010A1101000001000000110100000000000001001010100001C11101000001010101000000101001110001100000101011
100110100011010100111010001110010111110111001010110000000001101001101110000000100C001100010101001001
1101011010010101010001000000001001000001001010110100110001100000000000000011000101101001010010010101
1000000001A00001000000111010100110100010011010110011A000000110111110000010000101100111A0001000011101
100011011000110101111011011A01101001001010100011100101010100000C001101001010110011000000010011010001
1010000000000000110000000100000001001101000010000111010101001A11100000001010100010111101001000010111
1010011010001011010111110101101001C10001100010000000000001010000001010110000001010100000001011000001
1010000001010000000000000000001010001000001001000010000001000100000010111110110001110011000001000111
1010000111001100100A10001010100001010110000100001001A110001110010010000000001010000010011C11101C1001
1100100011010110011100000010110101001A0010010001110100001100011001111011111110100010010A000001001011
1100101000000100110100110100000001000001010101100000100010000001010001000010111000010101011110101001
100010101000100111000000010101101001101101000001010000000011100100110010001010C01001C101010000000001
1110000001010101010110101101010010000101000110010101100000011001000000100001011001000101010101011011
1000101010010C01000100000001000000010000000001001000101010000000101010000100101110110101001101001001
100000001000010001011101010101100100001001C10010000100001010010110010001000101000000010000000A100111
1011010010010111101A0001000101010011000000001001000110000001000101010000000000110011100101011011A011
1010101010100000001000101010001110101010101100010100000011100010100101000100001000000101010001000101
1000000010101010111000001010101000001000000001000000001000000000000101000011101010111000010100010011
1010101000101010100010110010000101011011001011101000100111110101010001010000001000000101011101111011
1010001010100010111010100100110101000000000000100010110000100001000101011100100111010111110110000001
100000011011101000101010A000000100110110110111010000001101110101101000100000010000110000011001000111
111111000000C00010011000011101000100100010000100100100010000000000101001100011010100A11111110000A101
10000000011011000001000010110101011000111000001000010111001111100000100000000000010110101A0000011101
11010101001000100000010001N0000101111000000110101010010001100001010010110110101000100100110100000001
10010000100010001010010111010101C100101C1100101011010110010110000100000000010A1010010001010101101001
1000011011100110101000A00011010100101C10100100000000100100000111010000010100000001000101100100101011
1010000000010000100110011100110010101011100100100101011010000000000010010000100000110000000A01000011
1010101101011100001001000010100000001A00000001101100100100111100101111111100100110000111111111010101
1001010000000101100001001000101101010111010111000011001010100011000000001011110000010C00000000001101
1010111100111100100000010101011001010100010100001110011000111100011110011000001101001101101011010011
101000100100001001001001000101010001001111000001011110001010001C100000010010100010101000101010010101
1111111101010100100110010101000000011000000010001100001011111010010110110000100100011011101001000001
1100001011000000000000100101011010000101101001000011100000101000100000000000110100000100000001011011
1011011001101001011010100101011000001000A1A101010000011001110010001101011011011001010001010100001001
1010100100100011001010100100011110110011100100011010100001100010110101000000000101000100110100100111
1000101011010000100111100001000000001100000011000010101100000000100100100010110000010101010010000001
1000100111010110000100010000001010000101010100110110100111000111010100010010000111010100111A1C1101C1
1100000000001001010000000011000001111010000101000010011000000000010101000000111000010010100010010001
1010101001010100010010000001101000001000110001110110101010010001000011011000000001101010101010100111
1000100011010000011011000000001010001101100011001000100100010010011010001011010101001000111100110001
1100001010110100000110100100000000110100000000100011110001001010000010100000100010001011111011100001
1100110101000001011010000101010000000010111000000011101000100010101000101010000100100010000000101101
10101001000010010101010100010100101C1100101011110000001010100010001010001010000000100101101010000101
1010110000000000111101010000010001100000101110000111010100101100000001001000111101001101000010010101
1010000100000100010001001010100101001010000001A11001010011100010100000010110000001011100000000000101
1011101000000000110111100000010100100000011110010011011010101010000000010100001000000A10000010000001
10000011001110000100CA010101000100011010000001100100000000000000101101000000000000001001100001000111
1001100010001100001111101100100001100111101100010101100100010100001001010001011110000100001101101001
1011001000100001010000101010110100100000000000000000000010101001011001001010000000100110100110100001
1000010101111101010100101010110110000101011110010000100101010101001001001001010000010000110000010101
1000010100C00101001000101000001101010100000001001000C00100000001010110101011001000000100101011000001
1101011010110000110011000110101000100101011100001110101011010111011110010000000111010011000010010001
10101000000000100000101000001010101001000001000100C0100101010000000010001010100100001010101001001011
100001011011000101101001110100101011111101000101011011000001011011C1010010000101A0100001000110111001
1101000000000101000000100100110000000011010000010000000100100001010001000000100001110101110000000101
1111111111111111111111111111111111111111111111111111111111111111111111111111111111111111111111111111