

closedDoorTex ./assets/textures/doors/porte 512x512.xpm

NO ./assets/textures/creepy/brown_old_wall_2.xpm
SO ./assets/textures/creepy/brown_old_wall_3.xpm
WE ./assets/textures/creepy/cement_old_wall_1.xpm
EA ./assets/textures/creepy/blood_old_wall.xpm

FloorTex ./assets/textures/floor-ceil/cracked-creme-granite_tiled_512x512.xpm
CeilTex  ./assets/textures/floor-ceil/white-cubes-3d_tiled_512.xpm

C 70,70,70
F 150,150,150

11111111111111111111111111111111111111111111111111
101010000000000000101001000001111110A1011100000101
101011011A10A101000010010101001110110000A000111101
10000101000001010100100101000000001010010100000011
1A111010010010010101000001001010101000010111011001
100000101A1000110101111000001010111110000000000011
10110010101010100100000010110000000000001110110101
10001000101010010001110000010100011011010000001001
100110011010100110000011110100101000C0010100101111
11110010000000111111010000000010011111001101A0A001
11A1001110011100000000000000A000A000100A0A00110111
101100000010000110A011001100101000010001010110A111
10000100100111101011000010110001010101110010100101
11010010000000000000110100000101010010001000111011
1000A100010011101011000A10000101000000000010100001
10100110000000000100001100100000011100111000C00011
10101010110101101101100000100010000001001010101001
10001000000000001100110001000101111100000A00000011
1101A110110111010010001000101010000001010111101001
100100000000000101001001010010000A1011A10000000011
1000A101101101000000101001W01010011000A1001010A011
11100000000001000011101100101010000101000000001101
1011101101011010001001010000001001110101010001A001
11000000010101001001101010000000100001C10010010001
11011011000101000100011011001110110A100A0101011111
10100100010000011000110000001001110010110101000001
110100101001010101010000101001001011000100A0000101
100101010001010000100110000001110000001A011001A101
1010000010A101010100010111010111010011010000101101
1011111010100001A110000100010110000100100011101001
10001000101010010101010000100C01110001001010100011
10111100101000010100000100110100000010000001001011
10000000100010110011000100000000011011010101101101
11111A10001010000011000111010111010010000001000001
100000001A1010101100010010010000100001000001011001
11110101000010100010101010100110010101010000010011
1000000011101011101000101010100000A000A00111101001
1110101100CA100000011011000A0011000110111000001001
100010000110000101100000010101A0001000101000101001
11001010100010101000101000000101001010100010101A01
10010110010000000000000010110100001010101000000101
110000010001110101000A1010000001000010100111110001
10A101010110AA010101010100111010001011100000000101
1101010000011011000A01000010A010101010001101101101
10000110111000000110001010101000000111001000001011
10110000000101011000101000010010110001000010100011
10000101111100000011000011001110010101110010A00111
10110100000001011100A01000000000010001000100111001
111000010000110A0A01101101010011000000110001000011
11111111111111111111111111111111111111111111111111