
NO ./assets/textures/brown_old_wall_2.xpm
SO ./assets/textures/brown_old_wall_3.xpm
WE ./assets/textures/cement_old_wall_1.xpm
EA ./assets/textures/blood_old_wall.xpm

C 70,70,70
F 150,150,150

closedDoorTex ./assets/textures/porte 512x512.xpm

animSprite MONSTER_1, 4, XPM, ./assets/textures/monster_mummie_

11111111111111111111111111111111111111111111111111
11111111111111000000000000000001111111111111111111
1111111111111111111001C111111111111111111111111111
11111111111111111110010111111111111111111111111111
1111111111111111111AA10111111111111111111111111111
11111111111111111110S1C111111111111111111111111111
11111111111111111110010111111111111111111111111111
11111111111111111110010111111111111111111111111111
11111111111111111110010111111111111111111111111111
11111111111111111110010111111111111111111111111111
11111111111111111110010111111111111111111111111111
1111111111111111111001A111111111111111111111111111
11111111111111111110010111111111100111111111111111
111111111111000000000AA000011111100111111111111111
111111111111000000A0000000011111100111100000000011
111111111111111111100101111111111A011110000A000011
11111111111111111110010111111111100111100000000011
11111111111000000000A0A000000111100111100000000011
111111111110000000000000000001111A0111100000000011
11111111111000000000000A000001111A0111100000000011
111111111110000000000A00000001111001111000A0000011
10000000000A00000000A00000000C00000000000000000001
11111111111000000000000A000001111001111000000AA011
10C00000A00A0A0000000A0000A00000000000000000000A01
11111111111000000000000000000111100111100000000011
111111111110000000000000000A011110011110000000A011
111111111110000000000000000001111001111A0A00000011
1111111111100A000A0000000000011110011110A000000011
1111111111100A00000000000000A111100111100000000011
11111111111A0000000000000000011110011110000A000011
111111111110000000000A0000000111111111100000000011
111111111110000000000A0000000111111111100000000011
11111111111000000000000000000111111111111111111111
11111111111000000000000000000111111111111111111111
11111111111A000A000A000000000111111111111111111111
11111111111000000000000000000111111111111111111111
1111111111100000000000000000A111111111111111111111
11111111111000A000A000000A000111111111111111111111
11111111111000A00000000000000111111111111111111111
11111111111000000000000000000111111111111111111111
11111111111000000000000000000111111111111111111111
11111111111111111110010111111111111111111111111111
111111000A0A00111110010111111111111111111111111111
10000000A00000000000000000000000000000000000000C01
11111100000000111110010111111111111111111111111111
11111111111111111110010111111111111111111111111111
11111111111111111110010111111111111111111111111111
11111111111111111110010111111111111111111111111111
11111111111111111110010111111111111111111111111111
11111111111111111111111111111111111111111111111111
