

closedDoorTex ./assets/textures/doors/porte 512x512.xpm

NO ./assets/textures/creepy/brown_old_wall_2.xpm
SO ./assets/textures/floor-ceil/wall-grey-blocks-photos2-512.xpm
WE ./assets/textures/creepy/cement_old_wall_1.xpm
EA ./assets/textures/creepy/blood_old_wall.xpm

FloorTex ./assets/textures/floor-ceil/black-marbled-surface-tiled512.xpm
CeilTex  ./assets/textures/floor-ceil/cracked-creme-granite_tiled_512x512.xpm

C 70,70,70
F 150,150,150


1111111111111111111111111111111111111111111111111111111111111111111111111111111111111111111111111111
1111110011010111111011010101011111001111110110111011110101111011100111101110111011010101110011001011
1111110011010111111011010101011111001111110110111011110101111011100111101110111011010101110011001011
1111110011010111111C11010101011111001111110110111011110101111011100111101110111011010101110011001C11
10000C000000000000000000000000000000000000000000000000000000000000000000000000000C000000000000000001
111111001101C111111011000000000011001111110110111011110101111011100111101110111011A10101110011001011
1111110011010111111011000000000011001111110110111011110101111011100111101110111011010101110011001011
1111110011010111111011000000000A110011111101101110110000000000111001111011101110110101A1110011001011
1111110011110111111011000000000011001111110110111011000000000011100111101110111011000001110011001011
1111110011110111111011000000000011000111110110111011000000000011100111101110111011000001110011001011
1111110011110111111011000000000011000111110110111011000000000011100111101110111011000001110011001011
100000A0000000000000000000000000000000000000000000000000000000000000000000000000000A0000000000000001
1000000000000000000000000000000000000000000000000000000000000000000000000000000000000000000000000001
1111110011110111111C11000000000011000111110110111011000000000011100111101110111011000001110011001011
1111110011110111111011000000000011000111110110111011000000000011100111101110111011000001110011001011
10000000000000000C0000000000000A00000000000000C0000000000000A000000000000000000000000000000000000001
1111110011110111111011000000000011000111110110111011000000000011100111101110111011000001110011001011
1111110011110111111011000000000011000111110110111A1100000000001000001110111011101100000111000A001011
1111110011110111111011010101011111000111110110111011000000000010000011101110111011000001110000001011
1111110011110111111011010100011111000100000000111011110101111A100000111C1110111011010101110000001011
1111110011110111000000010100011111000100000000111011110101111010000011101110111010000001110000001011
1111110011110111000000010100011111000100000000111011110101111010000011101110111010000001110000001C11
100000000000000000000000000000000000000000000A00C000000000000000000000C00000000000000000000000000001
11111100111101110000000101A001111100110000000011101111010111101A000011101110111010000001110000001011
1111110011110111000000A1010001111100110000000011101111C1011110100000111011101110100000011100000A1011
1111110011110111000000010100011111001100000000111011110101111010000011101110111011010101110000001011
1111110011110111111011010100011111001100000000111011110101111010000011101110111011010101110000001011
11111100111101111110110101000111110011000000001110111101C11110100A0011101110111001010101110011001011
111111001111011111101101A10001111100110000000011101111010111101000001110111011100100A000000011000001
1111110011110111111011010100011111001100000000111011110101111010000011101110111001000000000011000001
10C00000C000000000000000000000000000000000000000000000000000C00000000C000C00000000000000000000000001
11111100111101111110110101000110000001000000001110111101011110111A0111101110111001000000000011000001
1111110011100000111011010100011000000111110110111011110101111011100111101110111001000000000011000001
10000000000000000000000000A00000000000000000000000000000000000000000000000000000000000000000A0000001
10000000000000000000000000000000000000000000000000000000000000000000000000000000000000000000A0000001
1111110011110111111011010101011000000111110110111011110101111011100111000110111001000000000011000001
1111110011110111111000000000001000000111110110111011110101111011100111000110111001000000000011000001
11111100111101111110000000000010000001111101000000000001011110111001110001101110A1010101110011001011
10000000000000C0000000000000000000000000000000000000000000000000000000000C00000A000000A0000000000001
111111001111011111100000000000100000011111010000000A000101111011100111101110111001010101110011001011
1111110011110111111000000000001000000111110100000000000101111011100111101110111001010101110000000011
1111110011110111111000000000001111001100010100000000000101110001100111101110111011010101110000000011
11111100111101111110000000000011110011A001010000000000010111000110011110111011101101C101110000000011
111111001111011111100000000000111100110001010000000000010111000110011110111011101101010111A000000011
1100000000000000001000000000001111001100010100000000000101110001100111100000011011010101110000000011
1100000000000000001000000000001111001100010100000000000101110001100111100000011011010101110000000011
11000000000000000A100000000000111100110001011C1110111101011100011001111000000110110101C1110000000011
1100000000000000001000000000001111001100010110111011110101110001100111100000011011010101110000000011
100000000000000000000A000000000000000000000000000000000000000000000000000000000000000000000000000001
10000000000000000000000000000000000000000000000000000000000000000000000000000000000A0000000000000001
11000000000000000010000000000011110011000101101110111101011100011001111000000110110101A1110000000011
1100000000000000001011010101011111001100010110111011110101111011100111100000011011010101110000000011
1100000000000000001011010101011111001100010110111011110101111011100111101110111011010101110000000011
1100000000000000001011010101011111001100010110111011110101111011100111101110111011010101110000000011
110000000000000000101101010101111100110A010110111C1111010111101110011110111011101101010001000A000011
1000000000000000000000000000000000000000000000000000000000000000000000000C00C000000C0000000000000001
1111110011110100000000000000001111001111110110111011110101111011100111101110111011010101110000000011
1111110011110100000000000000001111001110000000001011110101111011100000000000011011010101110000000011
100000W00000000000000000000000000C0000000000000000000000000000000000000000000000C0000000000000000001
111111001111010000000000000000111100111000000000101111010111101110000000000001101101C101110000000011
1000C00000000000000000000000000000000000000000000000000000000000000000000000000000000000000000000001
1111100001110100000000000000001111001110000000001011110101111011100000000000011011010101110000000011
1111100001110100000000000000001111001110000000001011110101111011100000000000011011010101110011001011
1111100001110100000000000000001111001110000000001011110101111011100000000000011011010101110011001C11
111110000111011111101101010101111100111111011011101111C10111101110A000000000011011010101110011001011
1111100001110111111011010101011111001111110110111011110101111011100000000000011011010101110011001011
111110000111011111000A000000000111001111110110111C11110101111C11100111101110111011010101110011001011
1111100001110111110000000000000111001111110100111011110101111011100111101110111011010101110011001011
11111000011101111100000000000001110011111101A01110111101011110111001111C1110111011010101110011001011
1111100001110111110000000000000111001111110100111011110101111011100111101110111011010101110011001011
11111000011101111100000A0000000111001111110100111011110101111011100111101110111011010101110011001011
1111100001110111110000000000000111001111110100111011110101111011100111101110111011010101100001001011
11111000011101111100000000000001110A1111110100111011110101111011100111101110111011010001100001001011
1111110011110111110000000000000111001111110110111000000000000001100111101110111011010001100001001011
100000000000000000000000000000000000000000000000000A000000000000000000000000000000000000000000000001
1000000000000000000000000000000000000A00000000000000000000000000000000000000000000000000000000000001
11111100111101111100000000000001110011111101101110000000000000011A0111101110111011010001100001001011
10000000000000000000000000000000000000000000000A0000000000000000000C00000000000000000000000000000001
1111110011110111110000000000000111001111110110111000000000000001100111101110111011010001110011001011
111111001111011111000000000000011100111111011011100000000000000110000000000000000101C101110011001011
111111001111011111000000000A000111001111110110111000000000000001100000000000000001010101110011001011
1111110011110111110000000000000111001111110110111000000000000001100000000000000001010101110011001011
1111110011110111111011010101011111001111110110111011110101111011100000000000000001010101110011001011
111111001111011111101101010101111100110000000011101111010111101110000000000A000001010101110011001011
1111110011110111111011010101011111001100000000111011110101111011100000000000000001010101110011001011
11111100111101111110110101C1011111001100000000111011110101111011100000000000000001010101110011001011
1000000000000111111011010101C11111001100000000111011110101111011100000000000000001010101110000001011
100000000000000000000000000000000000000000000000000000000000000000000000A000000000000000000000000001
1000000000000111111000000000000000001111110110111000000000011011100000000000000001010101110000001C11
1000000000000111111000000000000000001111110110111000000000011011100000000000000001010101110000001011
100000000000011111100000000A00000000111111011011100000000001101110000000000000000101A101110000001011
100000000000011111100000000000000000111111A110111000000000011011100000000000000001010101110000001011
1000000000000000000000000000000000000C000000000000000000000000C0000000000000000000000000000000000001
100000000000011111100000000000000000111111011C111000000000011011100000000000000001010101110000001011
1000000000000111111000000000000000001111110110111000000000011011100000000000000001C10101110000001011
1111110011110111111000000000000000001111110110111000000000011011100111101110111011010101110000001011
11111100111101111110000000000000000011111101101110000000000110111001111A1110111C110101C1110000001C11
1111110011110111111011010101011111001111110110111000000000011C11100111101110111011010101110000001011
1111110011110111111011010101011111001111110110111011110101111011100111101110111011010101110011001011
1111111111111111111111111111111111111111111111111111111111111111111111111111111111111111111111111111